1111111111111111111
10P0000000000G000E1
1011110111101111101
1010000100000100001
10C011R0111010110B1
1011111111111111101
1000000000000000001
1111111111111111111
