1111111
10P0001
1011101
10G0001
101R101
101B001
1011101
10C0001
101E101
1111111
