1111111111111
10P00000000C1
1011110111101
1010000100001
1010110111101
10C010E0000C1
1110111111101
10000000000C1
1111111111111
