1111111111111
10P00000000C1
1011110111101
1010000100001
10C011E011101
1000000000001
1110111111101
10C01000000C1
1111111111111
