1111111
1000001
1011101
10P0001
1011101
1010001
1011111
1000001
1011101
1010001
1011101
10C0001
1011101
1010001
1011111
10C0001
10E0001
1111111
